NO ./assets/North.xpm 
SO ./assets/South.xpm 
F 0,255,255
WE ./assets/West.xpm 
EA ./assets/East.xpm 
C 128,128,128



111111111111111111111111
100005000000000000000001
100000000000000000000001
100000000000000000N00001
100500000000000000000001
100000000000000000000001
100000000000000000000001
100000000101110000000001
100000000100010000000001
100000000100010000000001
100000000111310000000001
100000000300030000000001
100011111100010000000001
100010000000010000000001
100010000000010000000001
1000010000000010000000001
100010000000010000000001
100010000111110000000001
1000100001000000000000001
100030000100000000000001
100011111100000000000001
100000000000000000000001
111111111111111111111111
