NO ./assets/North.xpm 
SO ./assets/South.xpm 
F 0,255,255
WE ./assets/West.xpm 
EA ./assets/East.xpm 
C 128,128,128


111111111111111111111111
100005000000000000000001
100000000010101100000001
100000000000000000100001
10050000000000W000100001
100000000000000000000001
100000000000000000000001
100000000101110000000001
100000000100010000000001
100000000100010000000001
100000000110010000000001
100000001310030000000001
100011111000010000000001
100010000000010000000001
100010000000010000000001
100001000000001000000001
100010000000010000010001
100010000111110000000001
100010000100000000000001
100030000100000000000001
100011111100000000000001
100000000000000000000001
111111111111111111111111
